# Gridmap generated by GridMapGenerator
# height width:
20 20
# minCost maxCost
1 50
# starting position:
0 0
# goal position:
19 19
# Blocked cells list
[
]
# Map: 
1 1 6 13 23 17 21 43 46 41 15 7 1 12 1 9 7 6 1 3 
1 1 1 11 10 28 12 20 15 16 11 2 1 1 35 17 5 8 10 1 
1 1 1 1 1 18 31 30 21 7 1 3 1 1 10 36 20 21 16 21 
1 1 1 1 1 4 18 43 45 24 8 1 1 1 10 13 41 24 33 17 
10 17 1 1 1 10 21 26 29 21 1 1 1 1 11 5 15 42 34 8 
28 18 10 1 1 1 2 20 10 13 1 2 1 23 14 3 9 19 15 3 
33 22 12 8 1 1 7 10 21 20 17 15 15 22 30 19 5 1 1 4 
42 20 22 11 9 1 1 2 18 42 37 38 27 20 27 46 19 1 1 1 
14 30 33 27 25 7 1 13 18 41 50 49 49 21 26 26 28 5 1 1 
9 40 34 40 21 13 20 1 23 39 46 29 28 29 10 3 16 6 1 1 
22 29 45 39 35 26 6 9 6 24 34 18 20 8 15 1 1 1 1 2 
3 17 30 33 48 30 28 22 30 15 26 43 33 25 1 1 1 1 1 1 
1 13 13 24 31 16 16 48 32 30 26 35 44 20 13 1 1 1 1 1 
2 1 14 15 1 13 22 34 47 22 24 24 50 37 7 1 1 2 2 1 
2 1 1 1 2 1 23 21 12 31 16 25 22 17 11 2 1 1 1 1 
10 14 1 1 2 15 11 40 19 22 41 28 27 1 6 1 2 1 1 1 
10 22 16 1 14 17 36 36 20 22 48 39 12 1 1 1 1 1 1 1 
39 22 18 29 22 18 28 49 28 27 21 33 12 1 1 2 1 1 2 1 
42 17 5 19 49 8 21 11 13 12 21 6 1 1 1 1 1 1 1 1 
24 22 12 27 20 22 16 8 3 9 11 4 1 1 1 1 1 1 1 1 
