# height width:
10 10
# minCost maxCost
1 50
# start (row1, col1)
0 0
# goal (row2, col2)
9 9
# Blocked cells (if any)
[
]
# Map:
1 1 1 1 1 1 1 1 1 1
1 1 50 50 50 50 1 1 1 1
1 1 1 1 1 50 1 1 1 1
1 1 50 50 50 50 1 1 1 50
1 1 1 1 1 50 1 1 1 1
1 1 50 1 1 50 50 50 50 1
1 1 50 1 1 1 50 1 1 1
1 1 50 1 1 1 1 50 1 1
1 1 50 50 50 50 50 50 1 1
1 1 1 50 1 1 1 1 1 1
